
F 100,100,100
C 153,255,255
NO ./Textures/cobblestone.xpm
SO ./Textures/color_stone.xpm
WE ./Textures/mossy_cobblestone1.xpm
EA ./Textures/netherrack.xpm

111111111
110S00011
100001001
111000001
111111111
