F   100,100,255
C   153,255,255
NO    ./Textures/cobblestone.xpm
SO    ./Textures/color_stone.xpm
WE    ./Textures/mossy_cobblestone1.xpm
EA    ./Textures/netherrack.xpm

111111110
100S01011
1000010111
100000000001
111111111111
